"","Gray Fox","Raccoon","Red Fox","Striped Skunk","Sum"
"AR",3,14,0,0,17
"FL",0,6,2,0,8
"GA",9,25,3,0,37
"KS",0,14,3,12,29
"KY",0,18,1,1,20
"LA",4,14,1,3,22
"MO",2,19,2,9,32
"NC",15,53,3,2,73
"NE",0,1,0,2,3
"PA",1,5,0,0,6
"TN",2,1,0,0,3
"VA",0,3,3,0,6
"WV",0,9,5,0,14
"Sum",36,182,23,29,270
